{
    "top": [
        "V02160A",
        "B00035C",
        "B00032B",
        "B00091C",
        "B00000B",
        "B00000C",
        "V08682B",
        "V02162B",
        "B00089C",
        "B00089D",
        "B00002A",
        "B00089A",
        "B00000D",
        "B00002C",
        "B00000A",
        "B00002B"
    ],
    "mid_top": [
        "V02160B",
        "C000RG1",
        "C000RG2",
        "P00574B",
        "P00665A",
        "B00061A",
        "B00061C",
        "B00076C",
        "V08682A",
        "V02166B",
        "C00ANG4",
        "B00091A",
        "B00091D",
        "P00537A",
        "B00032C",
        "B00032D",
        "B00035A",
        "B00032A",
        "P00538B"
    ],
    "mid": [
        "V05261B",
        "V05266A",
        "C00ANG3",
        "P00698A",
        "P00712A",
        "B00079B",
        "B00079C",
        "V09372A",
        "V09374A",
        "V04199A",
        "V00048B",
        "V00050A",
        "P00538A",
        "P00573A",
        "B00035B",
        "B00061B",
        "B00089B",
        "P00573B",
        "P00575A"
    ],
    "mid_bottom": [
        "V05266B",
        "V05268B",
        "C00ANG5",
        "C00ANG2",
        "P00909C",
        "P00661B",
        "P00574A",
        "V01386A",
        "V01403A",
        "V01404A",
        "V09724A",
        "V04545A",
        "V05267B",
        "V07646A",
        "V00050B",
        "V01387A",
        "P00661C",
        "P00662C",
        "P00664A",
        "V00048A",
        "V01240A",
        "P00574C",
        "P00661A",
        "P00662A",
        "P00662B"
    ],
    "bottom": [
        "V05612A",
        "V07647A",
        "V07647B",
        "V00074A",
        "V04549A",
        "V07298B",
        "V01406A",
        "V01415A",
        "V07302B",
        "V05261A",
        "V05268A",
        "V07302A",
        "P00665C",
        "P00748B",
        "P00909B",
        "B00091B",
        "V01389A",
        "V05267A",
        "V05612B",
        "P00665B",
        "P00748A",
        "P00698B"
    ]
}